{
  "tileSize": 32,
  "width": 40,
  "height": 30,
  "walls": [
    "########################################",
    "#......................................#",
    "#......................................#",
    "#......................................#",
    "#......................................#",
    "#......................................#",
    "#......................................#",
    "#......................................#",
    "#......................................#",
    "#......................................#",
    "#......................................#",
    "#......................................#",
    "#......................................#",
    "#......................................#",
    "#......................................#",
    "#......................................#",
    "#......................................#",
    "#......................................#",
    "#......................................#",
    "#......................................#",
    "#......................................#",
    "#......................................#",
    "#......................................#",
    "#......................................#",
    "#......................................#",
    "#......................................#",
    "#......................................#",
    "#......................................#",
    "#......................................#",
    "########################################"
  ]
}